N wolfenstein/Concrete_grey_5.xpm
S wolfenstein/Concrete_orange.xpm
W wolfenstein/door1.xpm
E wolfenstein/wood_moss_1.xpm

F 0,60,0
C 0,30,0


111111111111111111111111
1000000N0000000010010001
100000000101000000000001
100000000010000010010001
1000001D1010000010000001
1000000000D0000010000001
1010001D1010000010000001
100000000000000011000001
1000001D1000000010000001
111111111111111111111111
