N wolfenstein/Concrete_grey_5.xpm
S wolfenstein/Concrete_orange.xpm
W wolfenstein/door1.xpm
E wolfenstein/wood_moss_1.xpm

F 0,0,0
C 0,30,0


111111111111111111111111
100000000000000010100001
1000000000000000D0D00001
10000N000000000010100001
100000000000000010100001
100000000000000010100001
101000001000000010100001
100000000000000011100001
100000000000000010100001
111111111111111111111111
