N wolfenstein/blue_stone.xpm
S wolfenstein/color_stone.xpm
W wolfenstein/eagle.xpm
E wolfenstein/grey_stone.xpm

F 0,0,0
C 26,30,0

 111111111111111
1N00000000000001
1010000000000001
1000000000000001
1000000000000001
 111111111111111