N wolfenstein/Concrete_grey_5.xpm
S wolfenstein/Concrete_orange.xpm
W wolfenstein/door1.xpm
E wolfenstein/wood_moss_1.xpm

F 0,0,0
C 26,30,0

11111111111111111111111111111111111111
10000000000000100000000000000000000001
10000000000000100000000000000000000001
10000N00000000D00000000000000000000001
10000000000000100000000000000000000001
10000000000000101000000000000000000001
10100000100000100000000000000000000001
10000000000000100100000000000000000001
10000000000000100000000000000000000001
10000000000000100000000000000000000001
10000000000000000000000000000000000001
10000000000000100000000000000000000001
10000000000000100000000000000000000001
10000000000000100000000000000000000001
11111111111111111111111111111111111111