N wolfenstein/Concrete_grey_5.xpm
S wolfenstein/Concrete_orange.xpm
W wolfenstein/door1.xpm
E wolfenstein/wood_moss_1.xpm

F 0,0,0
C 0,30,0


111111111111111111111111
100000000000000010001001
1000000000000000D000D001
100000000000000010001001
1000000000000000D0001001
100000000000000010001001
1000000000000000D0001001
1010000N1000000010001001
100000000000000011001P11
100000000000000010001001
111111111111111111111111
