N wolfenstein/blue_stone.xpm
S wolfenstein/color_stone.xpm
W wolfenstein/eagle.xpm
E wolfenstein/grey_stone.xpm

F 0,30,100
C 26,30,0

111111111
100000001
101000101
100000001
1000N1001
101000001
100000101
101010011
111111111