N wolfenstein/blue_stone.xpm
S wolfenstein/color_stone.xpm
W wolfenstein/eagle.xpm
E wolfenstein/grey_stone.xpm

F 0,0,0
C 26,30,0

 11111111111111111111111111
1N00000000000001000000000001
1010000000000001000000000001
1000000000000001000000000001
1000000000000001000000000001
1010000000000001000000000001
1000001000000011000000000001
1010000000000000000000000001
1000000000000001000000000001
1010001000000001000000000001
1000000000000001000111111111
1000000000000011001
1010000000000001001111111111
1000000000000001000000000001
1000000100000001000000000001
1000000000000001000000000001
1010001000000001000000000001
1000000000000001000010000001
1000000000000001000000000001
1010000000000001000010000001
1000000000000001000000000001
1010000000000001000000000001
 11111111111111111111111111