N wolfenstein/Concrete_grey_5.xpm
S wolfenstein/Concrete_orange.xpm
W wolfenstein/door1.xpm
E wolfenstein/wood_moss_1.xpm

F 0,0,0
C 0,30,0


111111111111111111111111
100000000000000010000001
1000000000000000D0000001
10000N000000000010000001
100000000000000010000001
100000000000000010000001
101000001000000010000001
100000000000000011000001
100000000000000010000001
111111111111111111111111
